das Buch - книга
die Bücher - книги

das Haus - дом
die Häuser - дома

das Ei - яйцо
die Eier - яйца

gekochte Eier - вареные яйца

gern - с радостью
lieber - с бóльшей радостью

bei mir - у меня
bei dir - у тебя
bei ihm - у него
für mich - для меня
für dich - для тебя
für ihn - для него
bei ihr - у неё
bei uns - у нас
für sie - для неё
für uns - для нас
für euch - для вас, ребята
bei euch - у вас, ребята
bei ihnen - у них
bei Ihnen - у Вас
für sie - для них
für Sie - для Вас

der Umweg - обходной путь
der Briefumschlag - конверт для письма
umgekehrt - наоборот
um die Erde - вокруг земли
umorganisieren - переорганизовать
die Umleitung - объезд


Frage stellen - задать вопрос
die gleiche Frage - тот же вопрос

die Spannung - z.B. 220 Volt
entnehmen - отобрать, изъять, вынуть
entdecken - открывать (например совершать открытие)
sich entspannen - расслабляться
entmutigen - деморализовать
entgleisen - сходить с путей

der Gleis - путь, платформа, рельсы
der Schalter - окошко, стойка

die Decke - 1. одеяло 2. потолок
der Flaschendeckel - крышка
decken - покрывать

mutig - keine Angst

gefährlich - unsicher

sich - ся/себя/себе
ich - я
sicher - 1. безопасный, надежный 2. уверенный
hier - здесь
dort - там

am Nachmittag - после полудня
am Abend - вечером
nach der Arbeit - после работы
vor der Arbeit - перед работой
am Morgen - утром
am Vormittag - до полудня

ich entspanne mich - я расслабляюсь
du entspannst dich - ты расслабляешься
er entspannt sich - он расслабляется
sie entspannt sich - она расслабляется
wir entspannen uns - мы расслабляемся
ihr entspannt euch - вы, ребята, расслабляетесь
sie entspannen sich - они расслабляются
Sie entspannen sich - Вы расслабляетесь

normalerweise - типичным образом, в стандартной манере, обычно
die Weise - способ, манера
auf diese Weise - таким образом
auf die gleiche Weise - тем же самым образом

gewöhnlich - привычный
die Gewohnheit - привычка
die Essgewohnheiten - привычки питания

gleiche Essgewohnheiten - такие же привычки питания
er hat seine Essgewohnheiten nicht geändert - он не поменял свои привычки питания

wann haben Sie Zeit? - когда у вас есть время?
wann hast du Zeit? - когда у тебя есть время?
wenn die Zeit kommt - когда придет время
als ich jünger war - когда я была моложе
wenn ich hungrig bin - когда я голоден(а)
als wir mit Julian gesprochen haben - когда мы поговорили с Юлианом

die Regel - правило
die Regeln - правила
in der Regel - как правило, обычно
regelmäßig - регулярно
Hören regelmäßig üben - слушание регулярно тренировать 
die Übung - упражнение
die Übungen - упражнения
üben - упражняться, тренировать

