der Hinweis - указание, подсказка
hin*weisen - указывать
der Wegweiser - путеуказатель
der Beweis / der Nachweis - доказательство
beweisen / nach*weisen - доказывать
Sprachniveau nachweisen - доказать языковой уровень

die Überweisung - денежный перевод / направление к врачу
die Übersetzung - перевод
Überstunden - переработка, сверхурочные
die Übersicht - обзор, overview
die Schlüsselübergabe - передача ключей
über die Straße - через дорогу
übernachten - переночевать
übernehmen - принимать на себя
überreden - переубедить, уговорить
Geld überweisen - перевести деньги
auf das Konto überweisen - перевести на счёт
über 2 Mio. Menschen - более 2 млн людей
über 30 Grad - больше 30 градусов
über 900 Euro - более 900 евро

abnehmbar - снимаемый
unabnehmbar - неснимаемый
machbar - осуществимый
unmachbar - неосуществимый
lesbar - читабельный
unlesbar - нечитабельный
reparierbar - чинибельный
unreparierbar - нечинибельный
erklärbar - объяснимый
unerklärbar - необъяснимый
akzeptierbar - приемлемый
unakzeptierbar - неприемлемый

der Eingang - вход
der Ausgang - выход
die Einfahrt - въезд
die Ausfahrt - выезд
der Notausgang - экстренный выход
der Notfall - экстренный случай
der Notdienst - экстренная служба
der Nothahn - экстренный кран
in der Not - в нужде, в беде
nötig - нужный
unnötig - ненужный
benötigen - нуждаться
notwendig - необходимый

weg*fahren - уезжать прочь
weg*laufen - убегать прочь
weg*gehen - уходить прочь
der Umweg - обходной путь
los*fahren - начинать ехать
los*laufen - начинать бежать
los*gehen - начинать идти, отправляться в путь
los*fliegen - начинать лететь, взлетать
weg*fliegen - улетать прочь
weg*machen - убирать прочь

um*organisieren - переорганизовать
um*stellen - переставить
um*ziehen - переезжать
der Umzug - переезд
die Zeitumstellung - перевод часов
um die Sonne - вокруг Солнца
um die Erde - вокруг Земли
um die Welt - вокруг света
um die Ecke - за углом
der Dreieck - треугольник
der Rechteck - прямоугольник
die Umgebung - окружение
der Umbau des alten Gebäudes - перестройка старого здания
der Umweg - обходной путь
Umbau in der Sowjetunion - перестройка в СССР
Straßen-Umfrage - уличный опрос 
Online-Umfrage - онлайн опрос
die Umwelt - окружающий мир
die Umleitung - объезд
die Leitung - руководство
die Geschäftsleitung - руководство фирмы
der Leiter - руководитель
die Leiterin - руководительница

an*machen - включать
aus*machen - выключать
auf*machen - открывать
zu*machen - закрывать

sprechen - говорить
das Schreiben - письмо
besprechen - обсуждать 
die Besprechung - обсуждение
die Beschreibung - описание
schreiben - писать
beschreiben - описывать
arbeiten - работать
bearbeiten - обрабатывать, редактировать
lieben - любить
die Liebe - любовь
leben - жить (жизнь)
das Leben - жизнь
wohnen - проживать (где-то)
die Wohnung - квартира
bewohnen - обживать, заселять
das Ende - конец
das Wochenende - выходные, уикенд
beenden - заканчивать
Achtung! - внимание!
beachten - обращать внимание на

ein*schalten - включать
aus*schalten - выключать

rein*gehen - заходить (внутрь)
rein*kommen - входить (внутрь)
raus*gehen - выходить (наружу)
raus*legen - выкладывать (наружу)
rein*fahren - въезжать (внутрь)
rein*legen - класть (внутрь)
raus*kommen - выходить (наружу)
raus*fahren - выезжать (наружу)

auf dem Sofa - на диване
auf dem Bett - на кровати
auf*stehen - вставать
auf*wachen - просыпаться
die Aufnahme - 1. прием 2. запись (например видео)
die Notaufnahme - экстренная приемная в больнице
der Aufzug - лифт
die Aufgabe - задание
auf dem Tisch - на столе
auf dem Bild - на картинке

aus*ziehen - выезжать из квартиры
der Auszug - выезд из квартиры
der Kontoauszug - банковская выписка по счёту
ein*ziehen - въезжать в квартиру
der Einzug - въезд в квартиру
um*ziehen - переезжать
der Umzug - переезд
an*ziehen - надевать
ziehen - тянуть
der Zug - 1. поезд 2. затяжка 3. ход в игре
aus*ziehen - снимать
drücken - давить
der Druck - давление
der Drucker - принтер
der Ausdruck - expression, выражение
der Eindruck - impression, впечатление
großen Eindruck gemacht - произвело большое впечатление
interessanter Ausdruck - интересное выражение

mit*kommen - идти (с кем-то), присоединяться
mit*fahren - ехать (с кем-то), присоединяться
mit*nehmen - брать с собой
mit*spielen - играть (с кем-то), присоединяться к игре
mit*singen - петь (с кем-то)
mit*essen - есть (с кем-то), присоединяться к трапезе
mit*machen - соучаствовать, присоединяться к деятельности
mit*bringen - приносить/приводить с собой

ab*holen - забирать, получать (z.B. посылку)
die Abholung - получение (z.B. посылки)
ab*geben - сдавать, отдавать
ab*sagen - отменять
die Absage - отмена
die Terminabsage - отмена термина
ab*bauen - демонтировать, разбирать
ab*laufen - истекать (о времени)
die Ablauffrist - срок истечения
ab*brechen - 1. обламывать 2. прерывать, отменять
speichern - сохранять (z.B. файл)

nehmen - брать
entnehmen - извлекать
die Blutentnahme - забор крови
sperren - блокировать
die Sperre/Sperrung - блокировка
entsperren - разблокировать
die Spannung - напряжение
entspannen - расслабляться
entdecken - обнаруживать, открывать 
decken - покрывать

die Zustimmung - соглашение
der Zufall - совпадение
zufällig - случайно
zusammen - вместе
die Zusage - соглашение
der Zugang - доступ
die Zukunft - будущее
der Zusatz - добавка
zusätzlich - дополнительно
