ich muss - я должен / мне нужно
du musst - ты должен / тебе нужно
er muss - он должен / ему нужно
sie muss - она должна / ей нужно
wir müssen - мы должны / нам нужно
ihr müsst - вы, ребята, должны / вам, ребята, нужно
sie müssen - они должны / им нужно
Sie müssen - Вы должны / Вам нужно

ich kann - я могу
du kannst - ты можешь
er kann - он может
sie kann - она может
wir können - мы можем
ihr könnt - вы, ребята, можете
sie können - они могут
Sie können - Вы можете

ich darf - я имею право, разрешение
du darfst - ты имеешь право, разрешение
er darf - он имеет право, разрешение
sie darf - она имеет право, разрешение
wir dürfen - мы имеем право, разрешение
ihr dürft - вы, ребята, имеете право, разрешение
sie dürfen - они имеют право, разрешение
Sie dürfen - Вы имеете право, разрешение

ich will - я хочу
du willst - ты хочешь
er will - он хочет
sie will - она хочет
wir wollen - мы хотим
ihr wollt - вы, ребята, хотите
sie wollen - они хотят
Sie wollen - Вы хотите

ich möchte - я хотел бы
du möchtest - ты хотел(а) бы
er möchte - он хотел бы
sie möchte - она хотела бы
wir möchten - мы хотели бы
ihr möchtet - вы, ребята, хотели бы
sie möchten - они хотели бы
Sie möchten - Вы хотели бы

ich soll - мне указано / от меня хотят
du sollst - тебе указано / от тебя хотят
er soll - ему указано / от него хотят
sie soll - ей указано / от нее хотят
wir sollen - нам указано / от нас хотят
ihr sollt - вам указано / от вас хотят
sie sollen - им указано / от них хотят
Sie sollen - Вам указано / от Вас хотят