die Ohnmacht - обморок
in die Ohnmacht fallen - падать в обморок
ich falle - я падаю
du fällst - ты падаешь
er ist gefallen - он упал
das Fieber - высокая температура, лихорадка
so was - что-то такое, sth like that
die Niederlande - нидерланды
hoch - высокий
niedrig - низкий
der Druck - давление
der Blutdruck - кровяное давление
wegen + Gen/Dat - из-за
das Gerät - устройство
messen - измерять
der Maß - размер
das Blutdruckmessgerät - тонометр
die Apotheke - аптека
die Lust - настроение, желание что-то сделать
der Wert - value
das Angebot - предложение
der Anbieter - "предлагатель", поставщик услуг
nach Norden/Süden/Osten/Westen - на север/юг/..
nach vorne/hinten - вперед/назад
nach Warschau/Berlin - в Варшаву/Берлин
in Warschau/Berlin - в Варшаве/Берлине
nach Polen/Deutschland - в Польшу/Германию
in Polen/Deutschland - в Польше/Германии
nach Hause - домой
das Mal - раз
unterschiedliche - разные
das Bad - ванная комната, купальня
das Badzimmer - ванная комната
das Schwimmbad - бассейн
eher - rather
der Leiter - ведущий, управляющий, leader
die Firmenleitung - управление фирмы
das Wort - слово
die Wörter - слова
die Achtung - внимание
achten auf Akk - обращать внимание на
ziehen - тянуть
der Zug - 1. поезд 2. вдох 3. затяжка 4. ход в игре
der Gutschein - купон
die Gutschrift - пополнение
das Guthaben - баланс
die Lastschrift - списание
die Last - груз
atmen - дышать
die Atmung - дыхание
schenken - дарить
das Geschenk - подарок
der Schinken - ветчина
schneiden - резать
schicken - посылать
senden - отправлять
die Kette - цепь
die Lieferkette - цепь поставок
die Silberhalskette - серебряная цепочка на шею