der Nachbar - сосед
die Nachbarn - соседи
die Nachbarin - соседка
die Nachbarinnen - соседки
der Mitbewohner - сожитель
die Mitbewohner - сожители
die Mitbewohnerin - сожительница
die Mitbewohnerinnen - сожительницы

das wundert mich - это удивляет меня
das wundert dich - это удивляет тебя
das wundert ihn - это удивляет его
das wundert sie - это удивляет её
das wundert uns - это удивляет нас
das wundert euch - это удивляет вас, ребята
das wundert Sie - это удивляет Вас 
wundert das dich? - это удивляет тебя?
wundert das sie? - это удивляет её?
wundert das ihn? - это удивляет его?
wundert das euch? - это удивляет вас, ребята?
wundert das Sie? - это удивляет Вас? 
wundert das sie? - это удивляет их?

die Frage
die Fragen
die Aussage - высказывание
die Aussagen - высказывания
die Behauptung - утверждение
die Behauptungen - утверждения

bitten - просить
ich bitte - я прошу
du bittest - ты просишь
er bittet - он просит
sie bittet - она просит
wir bitten - мы просим
ihr bittet - вы, ребята, просите
sie bitten - они просят
Sie bitten - Вы просите

ich habe gebeten - я просил
du hast gebeten - ты просил
er hat gebeten - он просил
sie hat gebeten - она просила
wir haben gebeten - мы просили
ihr habt gebeten - вы, ребята, просили
sie haben gebeten - они просили
Sie haben gebeten - Вы просили

(an*)bieten - предлагать
ich biete - я предлагаю
du bietest - ты предлагаешь
er bietet - он предлагает
sie bietet - она предлагает
wir bieten - мы предлагаем
ihr bietet - вы, ребята, предлагаете
sie bieten - они предлагают
Sie bieten - Вы предлагаете

ich habe angeboten - я предложил
du hast angeboten - ты предложил
er hat angeboten - он предложил
sie hat angeboten - она предложила
wir haben angeboten - мы предложили
ihr habt angeboten - вы, ребята, предложили
sie haben angeboten - они предложили
Sie haben angeboten - Вы предложили


während - во время, пока
bis - until

der Teilnehmer - участник
die Teilnehmer - участники
die Teilnehmerin - участница
die Teilnehmerinnen - участницы

der Leiter - руководитель
die Leiter - руководители
die Leiterin - руководительница
die Leiterinnen - руководительницы

leider - к сожалению
das Lied - песня
die Lieder - песни
leiden - страдать

internationale Beziehungen - международные отношения

(ver)ändern - изменять
wechseln - заменить
(aus)tauschen - обменивать

Austauschsemester - обменный семестр
Auslandssemester - иностранный семестр

es ist genau das, was ich gemacht habe - это именно то, что я сделал

laufen lassen - let run

entweder ... oder ... - либо ... либо ...
sowohl ... als auch ... - как ... так и ...

drücken - давить
ich drücke - я нажимаю/давлю
du drückst - ты нажимаешь/давишь
er drückt - он нажимает/давит
sie drückt - она нажимает/давит
wir drücken - мы нажимаем/давим
ihr drückt - вы, ребята, нажимаете/давите
sie drücken - они нажимают/давят
Sie drücken - Вы нажимаете/давите

der Druck - давление
der Ausdruck - expression
der Eindruck - impression

aus*drucken - распечатать
ich drucke - я распечатываю
du druckst - ты распечатываешь
er druckt - он распечатывает
sie druckt - она распечатывает
wir drucken - мы распечатываем
ihr druckt - вы, ребята, распечатываете
sie drucken - они распечатывают
Sie drucken - Вы распечатываете

Kunstwerk - произведение искусства, работа
Werktage - Mo Di Mi Do Fr

der Kasten - ящик
die Kästen - ящики

die Speise - еда, блюдо (но не суд)
das Gericht - 1. еда, блюдо 2. суд
