der Fall - случай
die Fälle - случаи

der Notfall - экстренный случай
der Unfall - несчастный случай
der Zufall - совпадение

fallen - падать
gefallen - нравиться
das gefällt mir - мне это нравится
ich bin gefallen - я упал

der Fehler - ошибка
die Fehler - ошибки

ich komme gleich! - я сейчас приду!
er kommt gleich - он сейчас придет
sie kommt gleich - она сейчас придет
wir kommen gleich - мы сейчас придем
mein Zug kommt gleich - мой поезд сейчас придет
mein Bus kommt gleich - мой автобус сейчас придет
unser Zug kommt gleich - наш поезд сейчас придет
unser Bus kommt gleich - наш автобус сейчас придет
ich erkläre es dir gleich - сейчас я тебе это объясню
ich mache es gleich - сейчас я это сделаю

entscheiden - решать
er entscheidet - он решает
sie entscheidet - она решает
wer entscheidet? - кто решает?
wir entscheiden morgen - мы решим завтра

die Entscheidung - решение (decision, не solution)

ich habe entschieden - я решил
er hat entschieden  - он решил
sie hat entschieden - она решила

sonst - otherwise, else

was für - что за
was für ein Modell? - что за модель?
was für ein Problem? - что за проблема?
was für Leute? - что за люди?
was für eine Frage? - что за вопрос?

machbar - осуществимый
unmachbar - неосуществимый
lesbar - читабельный
unlesbar - нечитабельный
reparierbar - чинибельный
unreparierbar - нечинибельный

Fleischabteilung - мясной отдел
Tiefkühlabteilung - отдел глубокой заморозки
Milchprodukte-Abteilung - отдел молочных продуктов
Getränkeabteilung - отдел с напитками
Süßwarenabteilung - отдел сладких товаров
Obst- und Gemüseabteilung - отдел овощей и фруктов
Backwarenabteilung - отдел выпечки

Geflügel - птица
Hänchen - курица
Pute - индейка
Rindfleisch - говядина
Schweinefleisch - свинина
Hackfleisch - фарш

der Wasserhahn - водяной кран
der Nothahn - экстренный (тормозной) кран
der Notfall - экстренный случай
der Unfall - несчастный случай
der Zufall - совпадение
der Notausgang - экстренный выход
der Notarzt - врач скорой помощи
der Notruf - экстренный вызов, звонок SOS

der Grundriss - чертеж планировки

die Waschmaschine - стиральная машина
die Spülmaschine - посудомоечная машина

das Waschmittel - средство для стирки
das Spülmittel - моющее средство для посуды
das Desinfektionsmittel - дезинфицирующее средство
die Stadtmitte - центр города

die Mindestlaufzeit - минимальное время действия
die Mindestmietdauer - минимальная длительность аренды

die Frist - срок

6 Monate Kündigungsfrist - 6 месяцев срок расторжения

der Vertrag - договор
der Mietvertrag - договор аренды
der Arbeitsvertrag - трудовой договор
Vertrag schließen - заключать договор
Vertrag kündigen - расторгать договор

hat nichts zu tun mit - has nothing to do with
hat etwas zu tun mit - has something to do with

gleich - 1. такой же 2. сейчас же
ähnlich - похожий

Sicherheit - security 
Versicherung - insurance
Qualitätssicherung - quality assurance
ich bin (mir) nicht sicher - I'm not sure



