auf dem Tisch - на столе
auf den Tisch - на стол
von dem Tisch $ vom Tisch - со стола, от стола
mit dem Tisch - со столом
unter dem Tisch - под столом
vor dem Tisch - перед столом
ohne Tisch - без стола

aus dem Haus - из дома
in dem Haus - в доме
für das Haus - для дома
durch das Haus - через дом, сквозь дом
neben dem Haus - рядом с домом
hinter dem Haus - за домом
vor dem Haus - перед домом
zu dem Haus $ zum Haus - к дому

in der Waschmaschine - в стиральной машине
in die Waschmaschine - в стиральную машину
auf der Waschmaschine - на стиральной машине
auf die Waschmaschine - на стиральную машину
für die Waschmaschine - для стиральной машины
hinter der Waschmaschine - за стиральной машиной
unter der Waschmaschine - под стиральной машиной
vor der Waschmaschine - перед стиральной машиной
mit der Waschmaschine - со стиральной машиной
ohne Waschmaschine - без стиральной машины

nicht in der Waschmaschine - не в стиральной машине
nicht in die Waschmaschine - не в стиральную машину

in dem Kühlschrank $ im Kühlschrank - в холодильнике
in den Kühlschrank - в холодильник
unter dem Kühlschrank - под холодильником
hinter dem Kühlschrank - за холодильником
vor dem Kühlschrank - перед холодильником
für den Kühlschrank - для холодильника
mit dem Kühlschrank - с холодильником
aus dem Kühlschrank - из холодильника
ohne Kühlschrank - без холодильника

nicht in dem Kühlschrank $ nicht im Kühlschrank- не в холодильнике
nicht in den Kühlschrank - не в холодильник

in der Mikrowelle - в микроволновке
in die Mikrowelle - в микроволновку
für die Mikrowelle - для микроволновки
hinter der Mikrowelle - за микроволновкой
unter der Mikrowelle - под микроволновкой
mit der Mikrowelle - с микроволновкой
ohne Mikrowelle - без микроволновки

nicht in der Mikrowelle - не в микроволновке
nicht in die Mikrowelle - не в микроволновку

am Fluss - у реки
am Meer - у моря
am Strand - на пляже
am Bahnhof - на вокзале
am Flughafen - в аэропорту
an der Wand - на стене

nicht am Fluss - не у реки
nicht am Meer - не у моря
nicht am Strand - не на пляже
nicht am Bahnhof - не на вокзале
nicht am Flughafen - не в аэропорту
nicht an der Wand - не на стене

zum Fluss $ an den Fluss - к реке
zum Meer $ ans Meer $ an das Meer - к морю
zum Strand $ an den Strand - к пляжу
zum Bahnhof - к вокзалу
zum Flughafen - к аэропорту
an die Wand - на стену

auf dem Bild - на изображении, на картинке
aus dem Bild - из изображения, из картинки
ohne Bild - без изображения, без картинки

im Bett $ in dem Bett - в кровати
ins Bett $ in das Bett - в кровать
auf dem Bett - на кровати
auf das Bett - на кровать
für das Bett - для кровати
hinter dem Bett - за кроватью
unter dem Bett - под кроватью
vor dem Bett - перед кроватью
mit dem Bett - с кроватью
ohne Bett - без кровати

in der Tasche - в сумке
in die Tasche - в сумку
für die Tasche - для сумки
unter der Tasche - под сумкой
mit der Tasche - с сумкой
ohne Tasche - без сумки

im Keller $ in dem Keller - в подвале
aus dem Keller - из подвала
ohne Keller - без подвала

auf dem Dach - на крыше
unter dem Dach - под крышей

in der Wohnung - в квартире
in die Wohnung - в квартиру
für die Wohnung - для квартиры
mit der Wohnung $ mit Wohnung - с квартирой
ohne Wohnung - без квартиры

in der Küche - на кухне
in die Küche - на кухню, в кухню
für die Küche - для кухни
mit Küche - с кухней
ohne Küche - без кухни

im Schlafzimmer $ in dem Schlafzimmer - в спальне
ins Schlafzimmer $ in das Schlafzimmer - в спальню
für das Schlafzimmer - для спальни

im Bad $ in dem Bad - в ванной
ins Bad $ in das Bad - в ванную

