ich muss - I have to / I need
du musst - you have to / you need to / you must
er muss - he has to / he needs to / he must
sie muss - she has to / she needs to / she must
wir müssen - we have to / we need to / we must
ihr müsst - you guys have to / you guys need to / you guys must
sie müssen - they should / they need to / they must
Sie müssen - You have to / You need to / You must
man muss - one has to / one needs to / one must

ich kann - I can
du kannst - you can
er kann - he can
sie kann - she can
wir können - we can
ihr könnt - you guys can
sie können - they can
Sie können - You can
man kann - one can

ich darf - I have the right, permission
du darfst - you have the right, permission
er darf - he has the right, permission
sie darf - she has the right, permission
wir dürfen - we have the right, permission
ihr dürft - you guys have the right, permission
sie dürfen - they have the right, permission
Sie dürfen - You have the right, permission
man darf - possible (allowed)

ich will - I want
du willst - You want
er will - he wants
sie will - she want
wir wollen - we want
ihr wollt - do you guys want
sie wollen - they want
Sie wollen - You want

ich möchte - I would like to
du möchtest - would you like
er möchte - he would like
sie möchte - she would like
wir möchten - we would like
ihr möchtet - would you guys like
sie möchten - they would like
Sie möchten - Would you like

ich soll - I was told/wanted from me
du sollst - indicated to you / wanted from you
er soll - indicated to him/wanted from him
sie soll - she is told / wants from her
wir sollen - we are told / want from us
ihr sollt - indicated to you / wanted from you
sie sollen - they are told / want from them
Sie sollen - indicated to you / wanted from you