sein - быть
haben - иметь

sprechen - разговаривать, говорить
ich spreche - я разговариваю
du sprichst - ты разговариваешь
er spricht - он разговаривает
sie spricht - она разговаривает
wir sprechen - мы разговариваем
ihr sprecht - вы, ребята, разговариваете
sie sprechen - они разговаривают
Sie sprechen - Вы разговариваете

wohnen - проживать
ich wohne - я проживаю
du wohnst - ты проживаешь
er wohnt - он проживает
sie wohnt - она проживает
wir wohnen - мы проживаем
ihr wohnt - вы, ребята, проживаете
sie wohnen - они проживают
Sie wohnen - Вы проживаете

leben - жить (жизнь)
ich lebe - я живу (жизнь)
du lebst - ты живешь (жизнь)
er lebt - он живет (жизнь)
sie lebt - она живет (жизнь)
wir leben - мы живем (жизнь)
ihr lebt - вы, ребята, живете (жизнь)
sie leben - они живут (жизнь)
Sie leben - Вы живете (жизнь)

lieben - любить
ich liebe - я люблю
du liebst - ты любишь
er liebt - он любит
sie liebt - она любит
wir lieben - мы любим
ihr liebt - вы, ребята, любите
sie lieben - они любят
Sie lieben - Вы любите

senden - отправлять
ich sende - я отправляю
du sendest - ты отправляешь
er sendet - он отправляет
sie sendet - она отправляет
wir senden - мы отправляем
ihr sendet - вы, ребята, отправляете
sie senden - они отправляют
Sie senden - Вы отправляете

fragen - спрашивать
ich frage - я спрашиваю
du fragst - ты спрашиваешь
er fragt - он спрашивает
sie fragt - она спрашивает
wir fragen - мы спрашиваем
ihr fragt - вы, ребята, спрашиваете
sie fragen - они спрашивают
Sie fragen - Вы спрашиваете

antworten - отвечать
ich antworte - я отвечаю
du antwortest - ты отвечаешь
er antwortet - он отвечает
sie antwortet - она отвечает
wir antworten - мы отвечаем
ihr antwortet - вы, ребята, отвечаете
sie antworten - они отвечают
Sie antworten - Вы отвечаете

erklären - отвечать
ich erkläre - я объясняю
du erklärst - ты объясняешь
er erklärt - он объясняет
sie erklärt - она объясняет
wir erklären - мы объясняем
sie erklären - они объясняют
Sie erklären - Вы объясняете

gehen - идти
ich gehe - я иду
du gehst - ты идешь
er geht - он идет
sie geht - она идет
wir gehen - мы идем
ihr geht - вы, ребята, идете
sie gehen - они идут
Sie gehen - Вы идете

fahren - ехать
ich fahre - я еду
du fährst - ты едешь
er fährt - он едет
sie fährt - она едет
wir fahren - мы едем
ihr fahrt - вы, ребята, едете
sie fahren - они едут
Sie fahren - Вы едете

kommen - 1. приходить/приезжать/прибывать 2. быть откуда то родом 
ich komme - я 1. прихожу/приезжаю/прибываю 2. родом из
du kommst - ты 1. приходишь/приезжаешь/прибываешь 2. родом из
er kommt - он 1. приходит/приезжает/прибывает 2. родом из
sie kommt - она 1. приходит/приезжает/прибывает 2. родом из
wir kommen - мы 1. приходим/приезжаем/прибываем 2. родом из
ihr kommt - вы, ребята, 1. приходите/приезжаете/прибываете 2. родом из
sie kommen - они 1. приходят/приезжают/прибывают 2. родом из
Sie kommen - Вы 1. приходите/приезжаете/прибываете 2. родом из

das kostet $ es kostet - это стóит
sie kosten - они стóят

arbeiten - работать
ich arbeite - я работаю
du arbeitest - ты работаешь
er arbeitet - он работает
sie arbeitet - она работает
wir arbeiten - мы работаем
ihr arbeitet - вы, ребята, работаете
sie arbeiten - они работают
Sie arbeiten - Вы работаете

trinken - пить
ich trinke - я пью
du trinkst - ты пьешь
er trinkt - он пьет
sie trinkt - она пьет
wir trinken - мы пьем
ihr trinkt - вы, ребята, пьете
sie trinken - они пьют
Sie trinken - Вы пьете

essen - есть, кушать
ich esse - я ем
du isst - ты ешь
er isst - он ест
sie isst - она ест
wir essen - мы едим
ihr esst - вы, ребята, едите
sie essen - они едят
Sie essen - Вы едите
ich suche - я ищу

suchen - искать
ich suche - я ищу
du suchst - ты ищешь
er sucht - он ищет
sie sucht - она ищет
wir suchen - мы ищем
ihr sucht - вы, ребята, ищете
sie suchen - они ищут
Sie suchen - Вы ищете

finden - находить
ich finde - я нахожу
du findest - ты находишь
er findet - он находит
sie findet - она находит
wir finden - мы находим
ihr findet - вы, ребята, находите
sie finden - они находят
Sie finden - Вы находите

glauben - 1. полагать 2. верить
ich glaube - я 1. полагаю 2. верю
du glaubst - ты 1. полагаешь 2. веришь
er glaubt - он 1. полагает 2. верит
sie glaubt - она 1. полагает 2. верит
wir glauben - мы 1. полагаем 2. верим
ihr glaubt - вы, ребята, 1. полагаете 2. верите
sie glauben - они 1. полагают 2. верят
Sie glauben - Вы 1. полагаете 2. верите

brauchen - нуждаться
ich brauche - я нуждаюсь / мне нужно
du brauchst - ты нуждаешься / тебе нужно
er braucht - он нуждается / ему нужно
sie braucht - она нуждается / ей нужно
wir brauchen - мы нуждаемся / нам нужно
ihr braucht - вы, ребята, нуждаетесь / вам, ребята, нужно
sie brauchen - они нуждаются / им нужно
Sie brauchen - Вы нуждаетесь / Вам нужно

nutzen - использовать
ich nutze - я использую
du nutzt - ты используешь
er nutzt - он использует
sie nutzt - она использует
wir nutzen - мы используем
ihr nutzt - вы, ребята, используете
sie nutzen - они используют
Sie nutzen - Вы используете