Sozialnetzwerke - соц сети

geben - давать
ich gebe - я даю
du gibst - ты даешь
das Ergebnis - результат
er gibt - он даёт
sie gibt - она даёт
wir geben - мы даём
das Ergebnis - результат
ihr gebt - вы, ребята, даёте
geben - давать
sie geben - они дают
Sie geben - Вы даёте

unter dem Tisch - под столом
unter dem Bett - под кроватью
unter dem Sofa - под диваном
das Unternehmen - предприятие
U-Bahn - метро
S-Bahn - электрички

das Leben des Industrieunternehmens - жизнь индустриального предприятия 

denken - думать
ich denke - я думаю
du denkst - ты думаешь
ich danke - я благодарю
du dankst - ты благодаришь
er dankt - он благодарит
sie dankt - она благодарит
er denkt - он думает
denken - думать
sie denkt - она думает
wir denken - мы думаем
ihr denkt - вы, ребята, думаете
sie denken - они думают
danken - благодарить
Sie denken - Вы думаете
wir danken - мы благодарим
ihr dankt - вы, ребята, благодарите
sie danken - они благодарят
Sie danken - Вы благодарите
danken - благодарить

Eingang - вход
Ausgang - выход

Einfahrt - въезд
Ausfahrt - выезд

ein*steigen - садиться в транспорт
aus*steigen - выходить из транспорта

um*steigen - пересаживаться (например из поезда в автобус)

im Durchschnitt - в среднем

ein*schlafen - засыпать
durch*schlafen - проспать (всю ночь)

von...bis - от...до
ab - от

