deprimierend - depressing
die Depression - депрессия

traurig - грустный

grau - серый
grün - зеленый


spielendes Kind - playing child
fahrende Autos - едущие машины
auf einem Bein stehend - standing on one leg
singende Vögel - singing birds
kochende Suppe - boiling soup
rollendes Rad - rolling wheel
wachsender Baum - growing tree
in die Augen schauend - looking into the eyes

der erste - первый
ähnliche - похожие
echt - настоящий
achten - обращать внимание
ernst - серьезный
ehrlich - честный
erklären - объяснять
egal - всё равно
gleich - 1. одинаковый 2. сразу, сейчас же
vergleichen - сравнивать
der Vergleich - сравнение
der Unterschied - разница
unterscheiden - различать
unterschiedliche - разные

bei - у, при
beim Fahren - при вождении, с вождением
beim Sprechen - при говорении, с говорением
beim Trinken - при питье, с питьём
bei der Arbeit - при работе, на работе
bei mir - у меня
bei dir - у тебя
bei ihm - у него
bei ihr - у неё
bei uns - у нас
bei euch - у вас, ребята
bei ihnen - у них
bei Ihnen - у Вас

lösen - решать (проблему)
die Lösung - решение (проблемы)

entscheiden - принимать решение
die Entscheidung - решение (выбор)

anscheinend - apparently
scheinen - 1. shine 2. appear

